filename, language, TypeScript, CSS, JSON, HTML, SCSS, comment, blank, total
c:\Dev\mobilecontrol\src\FrontEnd\src\app\app.api.ts, TypeScript, 15, 0, 0, 0, 0, 3, 1, 19
c:\Dev\mobilecontrol\src\FrontEnd\src\app\app.component.html, HTML, 0, 0, 0, 1, 0, 0, 2, 3
c:\Dev\mobilecontrol\src\FrontEnd\src\app\app.component.ts, TypeScript, 22, 0, 0, 0, 0, 0, 5, 27
c:\Dev\mobilecontrol\src\FrontEnd\src\app\app.module.ts, TypeScript, 54, 0, 0, 0, 0, 2, 4, 60
c:\Dev\mobilecontrol\src\FrontEnd\src\app\app.routing.ts, TypeScript, 58, 0, 0, 0, 0, 0, 2, 60
c:\Dev\mobilecontrol\src\FrontEnd\src\app\company-groups\company-groups.component.html, HTML, 0, 0, 0, 23, 0, 1, 1, 25
c:\Dev\mobilecontrol\src\FrontEnd\src\app\company-groups\company-groups.component.ts, TypeScript, 11, 0, 0, 0, 0, 0, 5, 16
c:\Dev\mobilecontrol\src\FrontEnd\src\app\company-groups\costcenterarea\costcenterarea-cu\costcenterarea-cu.component.html, HTML, 0, 0, 0, 41, 0, 1, 10, 52
c:\Dev\mobilecontrol\src\FrontEnd\src\app\company-groups\costcenterarea\costcenterarea-cu\costcenterarea-cu.component.ts, TypeScript, 57, 0, 0, 0, 0, 0, 9, 66
c:\Dev\mobilecontrol\src\FrontEnd\src\app\company-groups\costcenterarea\costcenterarea-list\costcenterarea-list.component.html, HTML, 0, 0, 0, 76, 0, 0, 9, 85
c:\Dev\mobilecontrol\src\FrontEnd\src\app\company-groups\costcenterarea\costcenterarea-list\costcenterarea-list.component.ts, TypeScript, 74, 0, 0, 0, 0, 1, 11, 86
c:\Dev\mobilecontrol\src\FrontEnd\src\app\company-groups\costcenterarea\costcenterarea.component.html, HTML, 0, 0, 0, 1, 0, 0, 0, 1
c:\Dev\mobilecontrol\src\FrontEnd\src\app\company-groups\costcenterarea\costcenterarea.component.ts, TypeScript, 11, 0, 0, 0, 0, 0, 5, 16
c:\Dev\mobilecontrol\src\FrontEnd\src\app\company-groups\position\position-cu\position-cu.component.html, HTML, 0, 0, 0, 37, 0, 1, 11, 49
c:\Dev\mobilecontrol\src\FrontEnd\src\app\company-groups\position\position-cu\position-cu.component.ts, TypeScript, 57, 0, 0, 0, 0, 0, 9, 66
c:\Dev\mobilecontrol\src\FrontEnd\src\app\company-groups\position\position-list\position-list.component.html, HTML, 0, 0, 0, 72, 0, 0, 8, 80
c:\Dev\mobilecontrol\src\FrontEnd\src\app\company-groups\position\position-list\position-list.component.ts, TypeScript, 74, 0, 0, 0, 0, 1, 11, 86
c:\Dev\mobilecontrol\src\FrontEnd\src\app\company-groups\position\position.component.html, HTML, 0, 0, 0, 1, 0, 0, 0, 1
c:\Dev\mobilecontrol\src\FrontEnd\src\app\company-groups\position\position.component.ts, TypeScript, 11, 0, 0, 0, 0, 0, 5, 16
c:\Dev\mobilecontrol\src\FrontEnd\src\app\company-groups\subsidiary\subsidiary-cu\subsidiary-cu.component.html, HTML, 0, 0, 0, 37, 0, 1, 11, 49
c:\Dev\mobilecontrol\src\FrontEnd\src\app\company-groups\subsidiary\subsidiary-cu\subsidiary-cu.component.ts, TypeScript, 57, 0, 0, 0, 0, 0, 9, 66
c:\Dev\mobilecontrol\src\FrontEnd\src\app\company-groups\subsidiary\subsidiary-list\subsidiary-list.component.html, HTML, 0, 0, 0, 72, 0, 0, 8, 80
c:\Dev\mobilecontrol\src\FrontEnd\src\app\company-groups\subsidiary\subsidiary-list\subsidiary-list.component.ts, TypeScript, 74, 0, 0, 0, 0, 1, 11, 86
c:\Dev\mobilecontrol\src\FrontEnd\src\app\company-groups\subsidiary\subsidiary.component.html, HTML, 0, 0, 0, 1, 0, 0, 0, 1
c:\Dev\mobilecontrol\src\FrontEnd\src\app\company-groups\subsidiary\subsidiary.component.ts, TypeScript, 11, 0, 0, 0, 0, 0, 5, 16
c:\Dev\mobilecontrol\src\FrontEnd\src\app\company\company-cu\company-cu.component.css, CSS, 0, 37, 0, 0, 0, 0, 5, 42
c:\Dev\mobilecontrol\src\FrontEnd\src\app\company\company-cu\company-cu.component.html, HTML, 0, 0, 0, 207, 0, 0, 26, 233
c:\Dev\mobilecontrol\src\FrontEnd\src\app\company\company-cu\company-cu.component.ts, TypeScript, 73, 0, 0, 0, 0, 1, 12, 86
c:\Dev\mobilecontrol\src\FrontEnd\src\app\company\company-list\company-list.component.html, HTML, 0, 0, 0, 72, 0, 0, 8, 80
c:\Dev\mobilecontrol\src\FrontEnd\src\app\company\company-list\company-list.component.ts, TypeScript, 80, 0, 0, 0, 0, 2, 13, 95
c:\Dev\mobilecontrol\src\FrontEnd\src\app\company\company.component.html, HTML, 0, 0, 0, 1, 0, 1, 1, 3
c:\Dev\mobilecontrol\src\FrontEnd\src\app\company\company.component.ts, TypeScript, 11, 0, 0, 0, 0, 1, 5, 17
c:\Dev\mobilecontrol\src\FrontEnd\src\app\devices-groups\category\category-cu\category-cu.component.html, HTML, 0, 0, 0, 30, 0, 1, 10, 41
c:\Dev\mobilecontrol\src\FrontEnd\src\app\devices-groups\category\category-cu\category-cu.component.ts, TypeScript, 46, 0, 0, 0, 0, 0, 8, 54
c:\Dev\mobilecontrol\src\FrontEnd\src\app\devices-groups\category\category-list\category-list.component.html, HTML, 0, 0, 0, 68, 0, 0, 7, 75
c:\Dev\mobilecontrol\src\FrontEnd\src\app\devices-groups\category\category-list\category-list.component.ts, TypeScript, 74, 0, 0, 0, 0, 1, 11, 86
c:\Dev\mobilecontrol\src\FrontEnd\src\app\devices-groups\category\category.component.html, HTML, 0, 0, 0, 1, 0, 0, 0, 1
c:\Dev\mobilecontrol\src\FrontEnd\src\app\devices-groups\category\category.component.ts, TypeScript, 11, 0, 0, 0, 0, 0, 5, 16
c:\Dev\mobilecontrol\src\FrontEnd\src\app\devices-groups\devicemodel\devicemodel-cu\devicemodel-cu.component.html, HTML, 0, 0, 0, 38, 0, 1, 11, 50
c:\Dev\mobilecontrol\src\FrontEnd\src\app\devices-groups\devicemodel\devicemodel-cu\devicemodel-cu.component.ts, TypeScript, 59, 0, 0, 0, 0, 0, 9, 68
c:\Dev\mobilecontrol\src\FrontEnd\src\app\devices-groups\devicemodel\devicemodel-list\devicemodel-list.component.html, HTML, 0, 0, 0, 76, 0, 0, 9, 85
c:\Dev\mobilecontrol\src\FrontEnd\src\app\devices-groups\devicemodel\devicemodel-list\devicemodel-list.component.ts, TypeScript, 74, 0, 0, 0, 0, 1, 11, 86
c:\Dev\mobilecontrol\src\FrontEnd\src\app\devices-groups\devicemodel\devicemodel.component.html, HTML, 0, 0, 0, 1, 0, 0, 0, 1
c:\Dev\mobilecontrol\src\FrontEnd\src\app\devices-groups\devicemodel\devicemodel.component.ts, TypeScript, 11, 0, 0, 0, 0, 0, 5, 16
c:\Dev\mobilecontrol\src\FrontEnd\src\app\devices-groups\devices-groups.component.html, HTML, 0, 0, 0, 1, 0, 0, 1, 2
c:\Dev\mobilecontrol\src\FrontEnd\src\app\devices-groups\devices-groups.component.ts, TypeScript, 11, 0, 0, 0, 0, 0, 5, 16
c:\Dev\mobilecontrol\src\FrontEnd\src\app\devices-groups\manufacturer\manufacturer-cu\manufacturer-cu.component.html, HTML, 0, 0, 0, 30, 0, 1, 10, 41
c:\Dev\mobilecontrol\src\FrontEnd\src\app\devices-groups\manufacturer\manufacturer-cu\manufacturer-cu.component.ts, TypeScript, 46, 0, 0, 0, 0, 0, 8, 54
c:\Dev\mobilecontrol\src\FrontEnd\src\app\devices-groups\manufacturer\manufacturer-list\manufacturer-list.component.html, HTML, 0, 0, 0, 68, 0, 0, 7, 75
c:\Dev\mobilecontrol\src\FrontEnd\src\app\devices-groups\manufacturer\manufacturer-list\manufacturer-list.component.ts, TypeScript, 74, 0, 0, 0, 0, 1, 11, 86
c:\Dev\mobilecontrol\src\FrontEnd\src\app\devices-groups\manufacturer\manufacturer.component.html, HTML, 0, 0, 0, 1, 0, 0, 0, 1
c:\Dev\mobilecontrol\src\FrontEnd\src\app\devices-groups\manufacturer\manufacturer.component.ts, TypeScript, 11, 0, 0, 0, 0, 0, 5, 16
c:\Dev\mobilecontrol\src\FrontEnd\src\app\devices-groups\manufacturercategory\manufacturercategory-cu\manufacturercategory-cu.component.html, HTML, 0, 0, 0, 40, 0, 1, 9, 50
c:\Dev\mobilecontrol\src\FrontEnd\src\app\devices-groups\manufacturercategory\manufacturercategory-cu\manufacturercategory-cu.component.ts, TypeScript, 68, 0, 0, 0, 0, 0, 10, 78
c:\Dev\mobilecontrol\src\FrontEnd\src\app\devices-groups\manufacturercategory\manufacturercategory-list\manufacturercategory-list.component.html, HTML, 0, 0, 0, 72, 0, 0, 8, 80
c:\Dev\mobilecontrol\src\FrontEnd\src\app\devices-groups\manufacturercategory\manufacturercategory-list\manufacturercategory-list.component.ts, TypeScript, 74, 0, 0, 0, 0, 1, 11, 86
c:\Dev\mobilecontrol\src\FrontEnd\src\app\devices-groups\manufacturercategory\manufacturercategory.component.html, HTML, 0, 0, 0, 1, 0, 0, 0, 1
c:\Dev\mobilecontrol\src\FrontEnd\src\app\devices-groups\manufacturercategory\manufacturercategory.component.ts, TypeScript, 11, 0, 0, 0, 0, 0, 5, 16
c:\Dev\mobilecontrol\src\FrontEnd\src\app\employee\employee-cu\employee-cu.component.html, HTML, 0, 0, 0, 213, 0, 0, 35, 248
c:\Dev\mobilecontrol\src\FrontEnd\src\app\employee\employee-cu\employee-cu.component.ts, TypeScript, 92, 0, 0, 0, 0, 0, 9, 101
c:\Dev\mobilecontrol\src\FrontEnd\src\app\employee\employee-list\employee-list.component.html, HTML, 0, 0, 0, 75, 0, 0, 8, 83
c:\Dev\mobilecontrol\src\FrontEnd\src\app\employee\employee-list\employee-list.component.ts, TypeScript, 81, 0, 0, 0, 0, 1, 12, 94
c:\Dev\mobilecontrol\src\FrontEnd\src\app\employee\employee.component.html, HTML, 0, 0, 0, 1, 0, 1, 1, 3
c:\Dev\mobilecontrol\src\FrontEnd\src\app\employee\employee.component.ts, TypeScript, 11, 0, 0, 0, 0, 1, 5, 17
c:\Dev\mobilecontrol\src\FrontEnd\src\app\equipment\equipment-cu\equipment-cu.component.html, HTML, 0, 0, 0, 32, 0, 1, 4, 37
c:\Dev\mobilecontrol\src\FrontEnd\src\app\equipment\equipment-cu\equipment-cu.component.ts, TypeScript, 24, 0, 0, 0, 0, 0, 7, 31
c:\Dev\mobilecontrol\src\FrontEnd\src\app\equipment\equipment-list\equipment-list.component.html, HTML, 0, 0, 0, 55, 0, 0, 4, 59
c:\Dev\mobilecontrol\src\FrontEnd\src\app\equipment\equipment-list\equipment-list.component.ts, TypeScript, 56, 0, 0, 0, 0, 2, 12, 70
c:\Dev\mobilecontrol\src\FrontEnd\src\app\equipment\equipment.component.html, HTML, 0, 0, 0, 25, 0, 1, 3, 29
c:\Dev\mobilecontrol\src\FrontEnd\src\app\equipment\equipment.component.ts, TypeScript, 16, 0, 0, 0, 0, 0, 5, 21
c:\Dev\mobilecontrol\src\FrontEnd\src\app\equipmentlog\equipmentlog-day\equipmentlog-day.component.html, HTML, 0, 0, 0, 43, 0, 0, 7, 50
c:\Dev\mobilecontrol\src\FrontEnd\src\app\equipmentlog\equipmentlog-day\equipmentlog-day.component.ts, TypeScript, 47, 0, 0, 0, 0, 0, 8, 55
c:\Dev\mobilecontrol\src\FrontEnd\src\app\equipmentlog\equipmentlog-list\equipmentlog-list.component.html, HTML, 0, 0, 0, 77, 0, 0, 13, 90
c:\Dev\mobilecontrol\src\FrontEnd\src\app\equipmentlog\equipmentlog-list\equipmentlog-list.component.ts, TypeScript, 61, 0, 0, 0, 0, 2, 10, 73
c:\Dev\mobilecontrol\src\FrontEnd\src\app\equipmentlog\equipmentlog.component.html, HTML, 0, 0, 0, 17, 0, 1, 4, 22
c:\Dev\mobilecontrol\src\FrontEnd\src\app\equipmentlog\equipmentlog.component.ts, TypeScript, 24, 0, 0, 0, 0, 0, 5, 29
c:\Dev\mobilecontrol\src\FrontEnd\src\app\main.ts, TypeScript, 5, 0, 0, 0, 0, 0, 2, 7
c:\Dev\mobilecontrol\src\FrontEnd\src\app\models\BaseCommandResult.model.ts, TypeScript, 9, 0, 0, 0, 0, 2, 1, 12
c:\Dev\mobilecontrol\src\FrontEnd\src\app\models\category\CreateCategoryCommand.model.ts, TypeScript, 3, 0, 0, 0, 0, 0, 0, 3
c:\Dev\mobilecontrol\src\FrontEnd\src\app\models\category\GetCategoryResult.model.ts, TypeScript, 4, 0, 0, 0, 0, 0, 0, 4
c:\Dev\mobilecontrol\src\FrontEnd\src\app\models\category\UpdateCategoryCommand.model.ts, TypeScript, 4, 0, 0, 0, 0, 0, 0, 4
c:\Dev\mobilecontrol\src\FrontEnd\src\app\models\company\CreateCompanyCommand.model.ts, TypeScript, 26, 0, 0, 0, 0, 0, 0, 26
c:\Dev\mobilecontrol\src\FrontEnd\src\app\models\company\GetCompanyReducedResult.model.ts, TypeScript, 5, 0, 0, 0, 0, 0, 0, 5
c:\Dev\mobilecontrol\src\FrontEnd\src\app\models\company\GetCompanyResult.model.ts, TypeScript, 28, 0, 0, 0, 0, 0, 0, 28
c:\Dev\mobilecontrol\src\FrontEnd\src\app\models\company\UpdateCompanyCommand.model.ts, TypeScript, 29, 0, 0, 0, 0, 0, 0, 29
c:\Dev\mobilecontrol\src\FrontEnd\src\app\models\costcenterarea\CreateCostCenterAreaCommand.model.ts, TypeScript, 5, 0, 0, 0, 0, 0, 0, 5
c:\Dev\mobilecontrol\src\FrontEnd\src\app\models\costcenterarea\GetCostCenterAreaResult.model.ts, TypeScript, 7, 0, 0, 0, 0, 0, 0, 7
c:\Dev\mobilecontrol\src\FrontEnd\src\app\models\costcenterarea\UpdateCostCenterAreaCommand.model.ts, TypeScript, 6, 0, 0, 0, 0, 0, 0, 6
c:\Dev\mobilecontrol\src\FrontEnd\src\app\models\devicemodel\CreateDeviceModelCommand.model.ts, TypeScript, 4, 0, 0, 0, 0, 0, 0, 4
c:\Dev\mobilecontrol\src\FrontEnd\src\app\models\devicemodel\GetDeviceModelResult.model.ts, TypeScript, 8, 0, 0, 0, 0, 0, 0, 8
c:\Dev\mobilecontrol\src\FrontEnd\src\app\models\devicemodel\UpdateDeviceModelCommand.model.ts, TypeScript, 5, 0, 0, 0, 0, 0, 0, 5
c:\Dev\mobilecontrol\src\FrontEnd\src\app\models\employee\CreateEmployeeCommand.model.ts, TypeScript, 23, 0, 0, 0, 0, 0, 0, 23
c:\Dev\mobilecontrol\src\FrontEnd\src\app\models\employee\GetEmployeeResult.model.ts, TypeScript, 24, 0, 0, 0, 0, 0, 0, 24
c:\Dev\mobilecontrol\src\FrontEnd\src\app\models\employee\UpdateEmployeeCommand.model.ts, TypeScript, 24, 0, 0, 0, 0, 0, 0, 24
c:\Dev\mobilecontrol\src\FrontEnd\src\app\models\equipment\GetEquipmentReducedResult.model.ts, TypeScript, 12, 0, 0, 0, 0, 0, 1, 13
c:\Dev\mobilecontrol\src\FrontEnd\src\app\models\equipment\GetEquipmentResult.model.ts, TypeScript, 29, 0, 0, 0, 0, 0, 1, 30
c:\Dev\mobilecontrol\src\FrontEnd\src\app\models\equipment\GetEquipmentResumed.model.ts, TypeScript, 4, 0, 0, 0, 0, 0, 1, 5
c:\Dev\mobilecontrol\src\FrontEnd\src\app\models\equipmentlog\GetDatesAvailableForEquipmentLog.model.ts, TypeScript, 4, 0, 0, 0, 0, 0, 0, 4
c:\Dev\mobilecontrol\src\FrontEnd\src\app\models\equipmentlog\GetEquipmentLogResumedCommand.model.ts, TypeScript, 15, 0, 0, 0, 0, 0, 0, 15
c:\Dev\mobilecontrol\src\FrontEnd\src\app\models\manufacturer\CreateManufacturerCommand.model.ts, TypeScript, 3, 0, 0, 0, 0, 0, 0, 3
c:\Dev\mobilecontrol\src\FrontEnd\src\app\models\manufacturer\GetManufacturerResult.model.ts, TypeScript, 4, 0, 0, 0, 0, 0, 0, 4
c:\Dev\mobilecontrol\src\FrontEnd\src\app\models\manufacturer\UpdateManufacturerCommand.model.ts, TypeScript, 4, 0, 0, 0, 0, 0, 0, 4
c:\Dev\mobilecontrol\src\FrontEnd\src\app\models\manufacturercategory\CreateManufacturerCategoryCommand.model.ts, TypeScript, 4, 0, 0, 0, 0, 0, 0, 4
c:\Dev\mobilecontrol\src\FrontEnd\src\app\models\manufacturercategory\GetManufacturerCategoryResult.model.ts, TypeScript, 8, 0, 0, 0, 0, 0, 0, 8
c:\Dev\mobilecontrol\src\FrontEnd\src\app\models\manufacturercategory\UpdateManufacturerCategoryCommand.model.ts, TypeScript, 5, 0, 0, 0, 0, 0, 0, 5
c:\Dev\mobilecontrol\src\FrontEnd\src\app\models\position\CreatePositionCommand.model.ts, TypeScript, 4, 0, 0, 0, 0, 0, 0, 4
c:\Dev\mobilecontrol\src\FrontEnd\src\app\models\position\GetPositionResult.model.ts, TypeScript, 6, 0, 0, 0, 0, 0, 0, 6
c:\Dev\mobilecontrol\src\FrontEnd\src\app\models\position\UpdatePositionCommand.model.ts, TypeScript, 5, 0, 0, 0, 0, 0, 0, 5
c:\Dev\mobilecontrol\src\FrontEnd\src\app\models\subsidiary\CreateSubsidiaryCommand.model.ts, TypeScript, 4, 0, 0, 0, 0, 0, 0, 4
c:\Dev\mobilecontrol\src\FrontEnd\src\app\models\subsidiary\GetSubsidiaryResult.model.ts, TypeScript, 6, 0, 0, 0, 0, 0, 0, 6
c:\Dev\mobilecontrol\src\FrontEnd\src\app\models\subsidiary\UpdateSubsidiaryCommand.model.ts, TypeScript, 5, 0, 0, 0, 0, 0, 0, 5
c:\Dev\mobilecontrol\src\FrontEnd\src\app\models\userprofile\FileParameter.ts, TypeScript, 4, 0, 0, 0, 0, 0, 0, 4
c:\Dev\mobilecontrol\src\FrontEnd\src\app\models\userprofile\GetLoggedUserResult.model.ts, TypeScript, 9, 0, 0, 0, 0, 0, 0, 9
c:\Dev\mobilecontrol\src\FrontEnd\src\app\models\userprofile\GetUserProfileResult.model.ts, TypeScript, 4, 0, 0, 0, 0, 0, 0, 4
c:\Dev\mobilecontrol\src\FrontEnd\src\app\models\userprofile\LoginUserCommand.model.ts, TypeScript, 5, 0, 0, 0, 0, 0, 0, 5
c:\Dev\mobilecontrol\src\FrontEnd\src\app\models\userprofile\TokenAndRefreshToken.model.ts, TypeScript, 8, 0, 0, 0, 0, 0, 0, 8
c:\Dev\mobilecontrol\src\FrontEnd\src\app\modules\MobileControl.module.ts, TypeScript, 108, 0, 0, 0, 0, 7, 11, 126
c:\Dev\mobilecontrol\src\FrontEnd\src\app\modules\MobileControl.routing.ts, TypeScript, 28, 0, 0, 0, 0, 7, 5, 40
c:\Dev\mobilecontrol\src\FrontEnd\src\app\modules\auth\auth.guard.ts, TypeScript, 37, 0, 0, 0, 0, 2, 3, 42
c:\Dev\mobilecontrol\src\FrontEnd\src\app\modules\auth\auth.interceptor.ts, TypeScript, 129, 0, 0, 0, 0, 12, 17, 158
c:\Dev\mobilecontrol\src\FrontEnd\src\app\modules\auth\forbidden\forbidden.component.html, HTML, 0, 0, 0, 1, 0, 0, 0, 1
c:\Dev\mobilecontrol\src\FrontEnd\src\app\modules\auth\forbidden\forbidden.component.ts, TypeScript, 11, 0, 0, 0, 0, 0, 5, 16
c:\Dev\mobilecontrol\src\FrontEnd\src\app\modules\auth\forbidden\forbiddenmessage\forbiddenmessage.component.html, HTML, 0, 0, 0, 23, 0, 0, 3, 26
c:\Dev\mobilecontrol\src\FrontEnd\src\app\modules\auth\forbidden\forbiddenmessage\forbiddenmessage.component.ts, TypeScript, 11, 0, 0, 0, 0, 0, 5, 16
c:\Dev\mobilecontrol\src\FrontEnd\src\app\modules\material.module.ts, TypeScript, 84, 0, 0, 0, 0, 5, 5, 94
c:\Dev\mobilecontrol\src\FrontEnd\src\app\services\auth.service.ts, TypeScript, 133, 0, 0, 0, 0, 27, 20, 180
c:\Dev\mobilecontrol\src\FrontEnd\src\app\services\category.service.ts, TypeScript, 74, 0, 0, 0, 0, 1, 11, 86
c:\Dev\mobilecontrol\src\FrontEnd\src\app\services\company.service.ts, TypeScript, 173, 0, 0, 0, 0, 2, 13, 188
c:\Dev\mobilecontrol\src\FrontEnd\src\app\services\costcenterarea.service.ts, TypeScript, 84, 0, 0, 0, 0, 1, 12, 97
c:\Dev\mobilecontrol\src\FrontEnd\src\app\services\devicemodel.service.ts, TypeScript, 72, 0, 0, 0, 0, 1, 11, 84
c:\Dev\mobilecontrol\src\FrontEnd\src\app\services\employee.service.ts, TypeScript, 161, 0, 0, 0, 0, 7, 13, 181
c:\Dev\mobilecontrol\src\FrontEnd\src\app\services\equipment.service.ts, TypeScript, 68, 0, 0, 0, 0, 0, 8, 76
c:\Dev\mobilecontrol\src\FrontEnd\src\app\services\equipmentlog.service.ts, TypeScript, 56, 0, 0, 0, 0, 0, 7, 63
c:\Dev\mobilecontrol\src\FrontEnd\src\app\services\manufacturer.service.ts, TypeScript, 69, 0, 0, 0, 0, 1, 11, 81
c:\Dev\mobilecontrol\src\FrontEnd\src\app\services\manufacturercategory.service.ts, TypeScript, 72, 0, 0, 0, 0, 1, 11, 84
c:\Dev\mobilecontrol\src\FrontEnd\src\app\services\position.service.ts, TypeScript, 81, 0, 0, 0, 0, 1, 12, 94
c:\Dev\mobilecontrol\src\FrontEnd\src\app\services\subsidiary.service.ts, TypeScript, 81, 0, 0, 0, 0, 1, 12, 94
c:\Dev\mobilecontrol\src\FrontEnd\src\app\shared\custom.validators.ts, TypeScript, 19, 0, 0, 0, 0, 5, 5, 29
c:\Dev\mobilecontrol\src\FrontEnd\src\app\shared\dialog.service.ts, TypeScript, 20, 0, 0, 0, 0, 0, 4, 24
c:\Dev\mobilecontrol\src\FrontEnd\src\app\shared\error.handler.ts, TypeScript, 18, 0, 0, 0, 0, 4, 6, 28
c:\Dev\mobilecontrol\src\FrontEnd\src\app\shared\notification.service.ts, TypeScript, 46, 0, 0, 0, 0, 5, 9, 60
c:\Dev\mobilecontrol\src\FrontEnd\src\app\template\calendar\calendar.component.html, HTML, 0, 0, 0, 20, 0, 0, 1, 21
c:\Dev\mobilecontrol\src\FrontEnd\src\app\template\calendar\calendar.component.ts, TypeScript, 131, 0, 0, 0, 0, 5, 15, 151
c:\Dev\mobilecontrol\src\FrontEnd\src\app\template\calendar\calendar.module.ts, TypeScript, 15, 0, 0, 0, 0, 1, 4, 20
c:\Dev\mobilecontrol\src\FrontEnd\src\app\template\calendar\calendar.routing.ts, TypeScript, 11, 0, 0, 0, 0, 0, 4, 15
c:\Dev\mobilecontrol\src\FrontEnd\src\app\template\charts\charts.component.html, HTML, 0, 0, 0, 122, 0, 0, 1, 123
c:\Dev\mobilecontrol\src\FrontEnd\src\app\template\charts\charts.component.ts, TypeScript, 216, 0, 0, 0, 0, 9, 50, 275
c:\Dev\mobilecontrol\src\FrontEnd\src\app\template\charts\charts.module.ts, TypeScript, 15, 0, 0, 0, 0, 1, 4, 20
c:\Dev\mobilecontrol\src\FrontEnd\src\app\template\charts\charts.routing.ts, TypeScript, 11, 0, 0, 0, 0, 0, 4, 15
c:\Dev\mobilecontrol\src\FrontEnd\src\app\template\components\buttons\buttons.component.html, HTML, 0, 0, 0, 475, 0, 0, 1, 476
c:\Dev\mobilecontrol\src\FrontEnd\src\app\template\components\buttons\buttons.component.ts, TypeScript, 6, 0, 0, 0, 0, 0, 3, 9
c:\Dev\mobilecontrol\src\FrontEnd\src\app\template\components\components.module.ts, TypeScript, 31, 0, 0, 0, 0, 0, 4, 35
c:\Dev\mobilecontrol\src\FrontEnd\src\app\template\components\components.routing.ts, TypeScript, 52, 0, 0, 0, 0, 0, 4, 56
c:\Dev\mobilecontrol\src\FrontEnd\src\app\template\components\grid\grid.component.html, HTML, 0, 0, 0, 256, 0, 1, 1, 258
c:\Dev\mobilecontrol\src\FrontEnd\src\app\template\components\grid\grid.component.ts, TypeScript, 6, 0, 0, 0, 0, 0, 3, 9
c:\Dev\mobilecontrol\src\FrontEnd\src\app\template\components\icons\icons.component.html, HTML, 0, 0, 0, 28, 0, 0, 1, 29
c:\Dev\mobilecontrol\src\FrontEnd\src\app\template\components\icons\icons.component.ts, TypeScript, 6, 0, 0, 0, 0, 0, 3, 9
c:\Dev\mobilecontrol\src\FrontEnd\src\app\template\components\notifications\notifications.component.html, HTML, 0, 0, 0, 257, 0, 6, 5, 268
c:\Dev\mobilecontrol\src\FrontEnd\src\app\template\components\notifications\notifications.component.ts, TypeScript, 42, 0, 0, 0, 0, 1, 6, 49
c:\Dev\mobilecontrol\src\FrontEnd\src\app\template\components\panels\panels.component.html, HTML, 0, 0, 0, 297, 0, 3, 1, 301
c:\Dev\mobilecontrol\src\FrontEnd\src\app\template\components\panels\panels.component.ts, TypeScript, 6, 0, 0, 0, 0, 0, 3, 9
c:\Dev\mobilecontrol\src\FrontEnd\src\app\template\components\sweetalert\sweetalert.component.html, HTML, 0, 0, 0, 79, 0, 0, 1, 80
c:\Dev\mobilecontrol\src\FrontEnd\src\app\template\components\sweetalert\sweetalert.component.ts, TypeScript, 122, 0, 0, 0, 0, 0, 9, 131
c:\Dev\mobilecontrol\src\FrontEnd\src\app\template\components\typography\typography.component.html, HTML, 0, 0, 0, 103, 0, 0, 1, 104
c:\Dev\mobilecontrol\src\FrontEnd\src\app\template\components\typography\typography.component.ts, TypeScript, 6, 0, 0, 0, 0, 0, 3, 9
c:\Dev\mobilecontrol\src\FrontEnd\src\app\template\dashboard\dashboard.component.html, HTML, 0, 0, 0, 184, 0, 0, 1, 185
c:\Dev\mobilecontrol\src\FrontEnd\src\app\template\dashboard\dashboard.component.ts, TypeScript, 190, 0, 0, 0, 0, 6, 32, 228
c:\Dev\mobilecontrol\src\FrontEnd\src\app\template\dashboard\dashboard.module.ts, TypeScript, 22, 0, 0, 0, 0, 1, 3, 26
c:\Dev\mobilecontrol\src\FrontEnd\src\app\template\dashboard\dashboard.routing.ts, TypeScript, 13, 0, 0, 0, 0, 0, 4, 17
c:\Dev\mobilecontrol\src\FrontEnd\src\app\template\forms\extendedforms\extendedforms.component.html, HTML, 0, 0, 0, 209, 0, 1, 2, 212
c:\Dev\mobilecontrol\src\FrontEnd\src\app\template\forms\extendedforms\extendedforms.component.ts, TypeScript, 32, 0, 0, 0, 0, 1, 10, 43
c:\Dev\mobilecontrol\src\FrontEnd\src\app\template\forms\forms.module.ts, TypeScript, 33, 0, 0, 0, 0, 0, 5, 38
c:\Dev\mobilecontrol\src\FrontEnd\src\app\template\forms\forms.routing.ts, TypeScript, 31, 0, 0, 0, 0, 0, 3, 34
c:\Dev\mobilecontrol\src\FrontEnd\src\app\template\forms\regularforms\regularforms.component.html, HTML, 0, 0, 0, 334, 0, 0, 1, 335
c:\Dev\mobilecontrol\src\FrontEnd\src\app\template\forms\regularforms\regularforms.component.ts, TypeScript, 7, 0, 0, 0, 0, 0, 4, 11
c:\Dev\mobilecontrol\src\FrontEnd\src\app\template\forms\validationforms\field-error-display\field-error-display.component.css, CSS, 0, 12, 0, 0, 0, 1, 1, 14
c:\Dev\mobilecontrol\src\FrontEnd\src\app\template\forms\validationforms\field-error-display\field-error-display.component.html, HTML, 0, 0, 0, 6, 0, 1, 1, 8
c:\Dev\mobilecontrol\src\FrontEnd\src\app\template\forms\validationforms\field-error-display\field-error-display.component.ts, TypeScript, 10, 0, 0, 0, 0, 0, 4, 14
c:\Dev\mobilecontrol\src\FrontEnd\src\app\template\forms\validationforms\password-validator.component.ts, TypeScript, 12, 0, 0, 0, 0, 0, 2, 14
c:\Dev\mobilecontrol\src\FrontEnd\src\app\template\forms\validationforms\validationforms.component.html, HTML, 0, 0, 0, 227, 0, 76, 8, 311
c:\Dev\mobilecontrol\src\FrontEnd\src\app\template\forms\validationforms\validationforms.component.ts, TypeScript, 180, 0, 0, 0, 0, 6, 19, 205
c:\Dev\mobilecontrol\src\FrontEnd\src\app\template\forms\wizard\wizard.component.css, CSS, 0, 0, 0, 0, 0, 0, 1, 1
c:\Dev\mobilecontrol\src\FrontEnd\src\app\template\forms\wizard\wizard.component.html, HTML, 0, 0, 0, 179, 0, 3, 1, 183
c:\Dev\mobilecontrol\src\FrontEnd\src\app\template\forms\wizard\wizard.component.ts, TypeScript, 283, 0, 0, 0, 0, 7, 71, 361
c:\Dev\mobilecontrol\src\FrontEnd\src\app\template\layouts\admin\admin-layout.component.html, HTML, 0, 0, 0, 14, 0, 0, 2, 16
c:\Dev\mobilecontrol\src\FrontEnd\src\app\template\layouts\admin\admin-layout.component.ts, TypeScript, 133, 0, 0, 0, 0, 0, 9, 142
c:\Dev\mobilecontrol\src\FrontEnd\src\app\template\layouts\auth\auth-layout.component.html, HTML, 0, 0, 0, 34, 0, 5, 0, 39
c:\Dev\mobilecontrol\src\FrontEnd\src\app\template\layouts\auth\auth-layout.component.ts, TypeScript, 86, 0, 0, 0, 0, 1, 14, 101
c:\Dev\mobilecontrol\src\FrontEnd\src\app\template\maps\fullscreenmap\fullscreenmap.component.html, HTML, 0, 0, 0, 1, 0, 0, 1, 2
c:\Dev\mobilecontrol\src\FrontEnd\src\app\template\maps\fullscreenmap\fullscreenmap.component.ts, TypeScript, 46, 0, 0, 0, 0, 1, 5, 52
c:\Dev\mobilecontrol\src\FrontEnd\src\app\template\maps\googlemaps\googlemaps.component.html, HTML, 0, 0, 0, 42, 0, 0, 2, 44
c:\Dev\mobilecontrol\src\FrontEnd\src\app\template\maps\googlemaps\googlemaps.component.ts, TypeScript, 10, 0, 0, 0, 0, 58, 17, 85
c:\Dev\mobilecontrol\src\FrontEnd\src\app\template\maps\maps.module.ts, TypeScript, 22, 0, 0, 0, 0, 0, 6, 28
c:\Dev\mobilecontrol\src\FrontEnd\src\app\template\maps\maps.routing.ts, TypeScript, 25, 0, 0, 0, 0, 0, 3, 28
c:\Dev\mobilecontrol\src\FrontEnd\src\app\template\maps\vectormaps\vectormaps.component.html, HTML, 0, 0, 0, 18, 0, 0, 1, 19
c:\Dev\mobilecontrol\src\FrontEnd\src\app\template\maps\vectormaps\vectormaps.component.ts, TypeScript, 34, 0, 0, 0, 0, 1, 6, 41
c:\Dev\mobilecontrol\src\FrontEnd\src\app\template\mat-confirm-dialog\mat-confirm-dialog.component.html, HTML, 0, 0, 0, 8, 0, 0, 0, 8
c:\Dev\mobilecontrol\src\FrontEnd\src\app\template\mat-confirm-dialog\mat-confirm-dialog.component.ts, TypeScript, 17, 0, 0, 0, 0, 0, 5, 22
c:\Dev\mobilecontrol\src\FrontEnd\src\app\template\md\md-chart\md-chart.component.css, CSS, 0, 0, 0, 0, 0, 0, 1, 1
c:\Dev\mobilecontrol\src\FrontEnd\src\app\template\md\md-chart\md-chart.component.html, HTML, 0, 0, 0, 20, 0, 0, 2, 22
c:\Dev\mobilecontrol\src\FrontEnd\src\app\template\md\md-chart\md-chart.component.spec.ts, TypeScript, 20, 0, 0, 0, 0, 0, 6, 26
c:\Dev\mobilecontrol\src\FrontEnd\src\app\template\md\md-chart\md-chart.component.ts, TypeScript, 60, 0, 0, 0, 0, 0, 21, 81
c:\Dev\mobilecontrol\src\FrontEnd\src\app\template\md\md-table\md-table.component.html, HTML, 0, 0, 0, 22, 0, 1, 3, 26
c:\Dev\mobilecontrol\src\FrontEnd\src\app\template\md\md-table\md-table.component.ts, TypeScript, 21, 0, 0, 0, 0, 0, 7, 28
c:\Dev\mobilecontrol\src\FrontEnd\src\app\template\md\md.module.ts, TypeScript, 38, 0, 0, 0, 0, 0, 7, 45
c:\Dev\mobilecontrol\src\FrontEnd\src\app\template\pages\lock\lock.component.html, HTML, 0, 0, 0, 61, 0, 1, 3, 65
c:\Dev\mobilecontrol\src\FrontEnd\src\app\template\pages\lock\lock.component.ts, TypeScript, 22, 0, 0, 0, 0, 1, 4, 27
c:\Dev\mobilecontrol\src\FrontEnd\src\app\template\pages\login\login.component.html, HTML, 0, 0, 0, 79, 0, 2, 1, 82
c:\Dev\mobilecontrol\src\FrontEnd\src\app\template\pages\login\login.component.ts, TypeScript, 89, 0, 0, 0, 0, 4, 13, 106
c:\Dev\mobilecontrol\src\FrontEnd\src\app\template\pages\pages.module.ts, TypeScript, 26, 0, 0, 0, 0, 1, 5, 32
c:\Dev\mobilecontrol\src\FrontEnd\src\app\template\pages\pages.routing.ts, TypeScript, 23, 0, 0, 0, 0, 0, 4, 27
c:\Dev\mobilecontrol\src\FrontEnd\src\app\template\pages\pricing\pricing.component.html, HTML, 0, 0, 0, 107, 0, 0, 1, 108
c:\Dev\mobilecontrol\src\FrontEnd\src\app\template\pages\pricing\pricing.component.ts, TypeScript, 18, 0, 0, 0, 0, 0, 4, 22
c:\Dev\mobilecontrol\src\FrontEnd\src\app\template\pages\register\register.component.html, HTML, 0, 0, 0, 144, 0, 0, 2, 146
c:\Dev\mobilecontrol\src\FrontEnd\src\app\template\pages\register\register.component.ts, TypeScript, 18, 0, 0, 0, 0, 0, 3, 21
c:\Dev\mobilecontrol\src\FrontEnd\src\app\template\shared\fixedplugin\fixedplugin.component.css, CSS, 0, 0, 0, 0, 0, 0, 1, 1
c:\Dev\mobilecontrol\src\FrontEnd\src\app\template\shared\fixedplugin\fixedplugin.component.html, HTML, 0, 0, 0, 85, 0, 1, 1, 87
c:\Dev\mobilecontrol\src\FrontEnd\src\app\template\shared\fixedplugin\fixedplugin.component.spec.ts, TypeScript, 20, 0, 0, 0, 0, 0, 6, 26
c:\Dev\mobilecontrol\src\FrontEnd\src\app\template\shared\fixedplugin\fixedplugin.component.ts, TypeScript, 135, 0, 0, 0, 0, 7, 41, 183
c:\Dev\mobilecontrol\src\FrontEnd\src\app\template\shared\fixedplugin\fixedplugin.module.ts, TypeScript, 11, 0, 0, 0, 0, 0, 2, 13
c:\Dev\mobilecontrol\src\FrontEnd\src\app\template\shared\footer\footer.component.html, HTML, 0, 0, 0, 22, 0, 0, 1, 23
c:\Dev\mobilecontrol\src\FrontEnd\src\app\template\shared\footer\footer.component.ts, TypeScript, 8, 0, 0, 0, 0, 0, 3, 11
c:\Dev\mobilecontrol\src\FrontEnd\src\app\template\shared\footer\footer.module.ts, TypeScript, 10, 0, 0, 0, 0, 0, 3, 13
c:\Dev\mobilecontrol\src\FrontEnd\src\app\template\shared\navbar\navbar.component.html, HTML, 0, 0, 0, 36, 0, 25, 0, 61
c:\Dev\mobilecontrol\src\FrontEnd\src\app\template\shared\navbar\navbar.component.ts, TypeScript, 186, 0, 0, 0, 0, 7, 29, 222
c:\Dev\mobilecontrol\src\FrontEnd\src\app\template\shared\navbar\navbar.module.ts, TypeScript, 11, 0, 0, 0, 0, 0, 2, 13
c:\Dev\mobilecontrol\src\FrontEnd\src\app\template\sidebar\sidebar.component.html, HTML, 0, 0, 0, 103, 0, 12, 6, 121
c:\Dev\mobilecontrol\src\FrontEnd\src\app\template\sidebar\sidebar.component.ts, TypeScript, 105, 0, 0, 0, 0, 11, 14, 130
c:\Dev\mobilecontrol\src\FrontEnd\src\app\template\sidebar\sidebar.module.ts, TypeScript, 10, 0, 0, 0, 0, 0, 3, 13
c:\Dev\mobilecontrol\src\FrontEnd\src\app\template\tables\datatable.net\datatable.component.html, HTML, 0, 0, 0, 58, 0, 5, 1, 64
c:\Dev\mobilecontrol\src\FrontEnd\src\app\template\tables\datatable.net\datatable.component.ts, TypeScript, 96, 0, 0, 0, 0, 4, 17, 117
c:\Dev\mobilecontrol\src\FrontEnd\src\app\template\tables\extendedtable\extendedtable.component.html, HTML, 0, 0, 0, 202, 0, 0, 1, 203
c:\Dev\mobilecontrol\src\FrontEnd\src\app\template\tables\extendedtable\extendedtable.component.ts, TypeScript, 67, 0, 0, 0, 0, 0, 5, 72
c:\Dev\mobilecontrol\src\FrontEnd\src\app\template\tables\regulartable\regulartable.component.html, HTML, 0, 0, 0, 106, 0, 0, 6, 112
c:\Dev\mobilecontrol\src\FrontEnd\src\app\template\tables\regulartable\regulartable.component.ts, TypeScript, 47, 0, 0, 0, 0, 0, 4, 51
c:\Dev\mobilecontrol\src\FrontEnd\src\app\template\tables\tables.module.ts, TypeScript, 23, 0, 0, 0, 0, 0, 6, 29
c:\Dev\mobilecontrol\src\FrontEnd\src\app\template\tables\tables.routing.ts, TypeScript, 25, 0, 0, 0, 0, 0, 3, 28
c:\Dev\mobilecontrol\src\FrontEnd\src\app\template\timeline\timeline.component.html, HTML, 0, 0, 0, 95, 0, 0, 1, 96
c:\Dev\mobilecontrol\src\FrontEnd\src\app\template\timeline\timeline.component.ts, TypeScript, 6, 0, 0, 0, 0, 0, 3, 9
c:\Dev\mobilecontrol\src\FrontEnd\src\app\template\timeline\timeline.module.ts, TypeScript, 15, 0, 0, 0, 0, 0, 4, 19
c:\Dev\mobilecontrol\src\FrontEnd\src\app\template\timeline\timeline.routing.ts, TypeScript, 11, 0, 0, 0, 0, 0, 4, 15
c:\Dev\mobilecontrol\src\FrontEnd\src\app\template\userpage\user.component.html, HTML, 0, 0, 0, 114, 0, 0, 1, 115
c:\Dev\mobilecontrol\src\FrontEnd\src\app\template\userpage\user.component.ts, TypeScript, 6, 0, 0, 0, 0, 0, 3, 9
c:\Dev\mobilecontrol\src\FrontEnd\src\app\template\userpage\user.module.ts, TypeScript, 15, 0, 0, 0, 0, 0, 4, 19
c:\Dev\mobilecontrol\src\FrontEnd\src\app\template\userpage\user.routing.ts, TypeScript, 11, 0, 0, 0, 0, 0, 4, 15
c:\Dev\mobilecontrol\src\FrontEnd\src\app\template\widgets\widgets.component.html, HTML, 0, 0, 0, 312, 0, 0, 5, 317
c:\Dev\mobilecontrol\src\FrontEnd\src\app\template\widgets\widgets.component.ts, TypeScript, 53, 0, 0, 0, 0, 0, 7, 60
c:\Dev\mobilecontrol\src\FrontEnd\src\app\template\widgets\widgets.module.ts, TypeScript, 17, 0, 0, 0, 0, 0, 4, 21
c:\Dev\mobilecontrol\src\FrontEnd\src\app\template\widgets\widgets.routing.ts, TypeScript, 11, 0, 0, 0, 0, 0, 4, 15
c:\Dev\mobilecontrol\src\FrontEnd\src\assets\css\demo.css, CSS, 0, 185, 0, 0, 0, 10, 33, 228
c:\Dev\mobilecontrol\src\FrontEnd\src\assets\scss\core\_alerts.scss, SCSS, 0, 0, 0, 0, 43, 2, 10, 55
c:\Dev\mobilecontrol\src\FrontEnd\src\assets\scss\core\_badges.scss, SCSS, 0, 0, 0, 0, 8, 0, 2, 10
c:\Dev\mobilecontrol\src\FrontEnd\src\assets\scss\core\_buttons.scss, SCSS, 0, 0, 0, 0, 185, 27, 33, 245
c:\Dev\mobilecontrol\src\FrontEnd\src\assets\scss\core\_cards.scss, SCSS, 0, 0, 0, 0, 311, 9, 56, 376
c:\Dev\mobilecontrol\src\FrontEnd\src\assets\scss\core\_carousel.scss, SCSS, 0, 0, 0, 0, 87, 2, 13, 102
c:\Dev\mobilecontrol\src\FrontEnd\src\assets\scss\core\_checkboxes.scss, SCSS, 0, 0, 0, 0, 184, 4, 23, 211
c:\Dev\mobilecontrol\src\FrontEnd\src\assets\scss\core\_core-bootstrap.scss, SCSS, 0, 0, 0, 0, 0, 66, 1, 67
c:\Dev\mobilecontrol\src\FrontEnd\src\assets\scss\core\_custom-forms.scss, SCSS, 0, 0, 0, 0, 2, 8, 1, 11
c:\Dev\mobilecontrol\src\FrontEnd\src\assets\scss\core\_drawer.scss, SCSS, 0, 0, 0, 0, 49, 56, 17, 122
c:\Dev\mobilecontrol\src\FrontEnd\src\assets\scss\core\_dropdown.scss, SCSS, 0, 0, 0, 0, 167, 6, 33, 206
c:\Dev\mobilecontrol\src\FrontEnd\src\assets\scss\core\_example-pages.scss, SCSS, 0, 0, 0, 0, 164, 0, 17, 181
c:\Dev\mobilecontrol\src\FrontEnd\src\assets\scss\core\_fixed-plugin.scss, SCSS, 0, 0, 0, 0, 256, 0, 47, 303
c:\Dev\mobilecontrol\src\FrontEnd\src\assets\scss\core\_footers.scss, SCSS, 0, 0, 0, 0, 88, 0, 16, 104
c:\Dev\mobilecontrol\src\FrontEnd\src\assets\scss\core\_forms.scss, SCSS, 0, 0, 0, 0, 293, 82, 61, 436
c:\Dev\mobilecontrol\src\FrontEnd\src\assets\scss\core\_headers.scss, SCSS, 0, 0, 0, 0, 65, 0, 11, 76
c:\Dev\mobilecontrol\src\FrontEnd\src\assets\scss\core\_images.scss, SCSS, 0, 0, 0, 0, 9, 0, 2, 11
c:\Dev\mobilecontrol\src\FrontEnd\src\assets\scss\core\_info-areas.scss, SCSS, 0, 0, 0, 0, 54, 0, 7, 61
c:\Dev\mobilecontrol\src\FrontEnd\src\assets\scss\core\_input-group.scss, SCSS, 0, 0, 0, 0, 26, 7, 7, 40
c:\Dev\mobilecontrol\src\FrontEnd\src\assets\scss\core\_layout.scss, SCSS, 0, 0, 0, 0, 59, 13, 10, 82
c:\Dev\mobilecontrol\src\FrontEnd\src\assets\scss\core\_list-group.scss, SCSS, 0, 0, 0, 0, 63, 24, 16, 103
c:\Dev\mobilecontrol\src\FrontEnd\src\assets\scss\core\_misc.scss, SCSS, 0, 0, 0, 0, 390, 6, 57, 453
c:\Dev\mobilecontrol\src\FrontEnd\src\assets\scss\core\_mixins.scss, SCSS, 0, 0, 0, 0, 16, 0, 1, 17
c:\Dev\mobilecontrol\src\FrontEnd\src\assets\scss\core\_modal.scss, SCSS, 0, 0, 0, 0, 144, 9, 27, 180
c:\Dev\mobilecontrol\src\FrontEnd\src\assets\scss\core\_nav.scss, SCSS, 0, 0, 0, 0, 27, 5, 7, 39
c:\Dev\mobilecontrol\src\FrontEnd\src\assets\scss\core\_navbar.scss, SCSS, 0, 0, 0, 0, 150, 2, 28, 180
c:\Dev\mobilecontrol\src\FrontEnd\src\assets\scss\core\_nucleo-outline.scss, SCSS, 0, 0, 0, 0, 383, 29, 123, 535
c:\Dev\mobilecontrol\src\FrontEnd\src\assets\scss\core\_pagination.scss, SCSS, 0, 0, 0, 0, 100, 52, 16, 168
c:\Dev\mobilecontrol\src\FrontEnd\src\assets\scss\core\_pills.scss, SCSS, 0, 0, 0, 0, 117, 0, 15, 132
c:\Dev\mobilecontrol\src\FrontEnd\src\assets\scss\core\_popover.scss, SCSS, 0, 0, 0, 0, 45, 0, 9, 54
c:\Dev\mobilecontrol\src\FrontEnd\src\assets\scss\core\_popups.scss, SCSS, 0, 0, 0, 0, 70, 0, 16, 86
c:\Dev\mobilecontrol\src\FrontEnd\src\assets\scss\core\_progress.scss, SCSS, 0, 0, 0, 0, 41, 0, 2, 43
c:\Dev\mobilecontrol\src\FrontEnd\src\assets\scss\core\_radios.scss, SCSS, 0, 0, 0, 0, 75, 1, 22, 98
c:\Dev\mobilecontrol\src\FrontEnd\src\assets\scss\core\_reboot.scss, SCSS, 0, 0, 0, 0, 11, 10, 4, 25
c:\Dev\mobilecontrol\src\FrontEnd\src\assets\scss\core\_responsive.scss, SCSS, 0, 0, 0, 0, 261, 2, 31, 294
c:\Dev\mobilecontrol\src\FrontEnd\src\assets\scss\core\_ripples.scss, SCSS, 0, 0, 0, 0, 36, 1, 5, 42
c:\Dev\mobilecontrol\src\FrontEnd\src\assets\scss\core\_switches.scss, SCSS, 0, 0, 0, 0, 75, 4, 8, 87
c:\Dev\mobilecontrol\src\FrontEnd\src\assets\scss\core\_tabs.scss, SCSS, 0, 0, 0, 0, 58, 1, 15, 74
c:\Dev\mobilecontrol\src\FrontEnd\src\assets\scss\core\_togglebutton.scss, SCSS, 0, 0, 0, 0, 72, 6, 8, 86
c:\Dev\mobilecontrol\src\FrontEnd\src\assets\scss\core\_tooltip.scss, SCSS, 0, 0, 0, 0, 46, 2, 6, 54
c:\Dev\mobilecontrol\src\FrontEnd\src\assets\scss\core\_type.scss, SCSS, 0, 0, 0, 0, 81, 2, 10, 93
c:\Dev\mobilecontrol\src\FrontEnd\src\assets\scss\core\_variables.scss, SCSS, 0, 0, 0, 0, 28, 2, 7, 37
c:\Dev\mobilecontrol\src\FrontEnd\src\assets\scss\core\cards\_card-background.scss, SCSS, 0, 0, 0, 0, 41, 0, 7, 48
c:\Dev\mobilecontrol\src\FrontEnd\src\assets\scss\core\cards\_card-blog.scss, SCSS, 0, 0, 0, 0, 20, 0, 2, 22
c:\Dev\mobilecontrol\src\FrontEnd\src\assets\scss\core\cards\_card-collapse.scss, SCSS, 0, 0, 0, 0, 37, 0, 8, 45
c:\Dev\mobilecontrol\src\FrontEnd\src\assets\scss\core\cards\_card-contact.scss, SCSS, 0, 0, 0, 0, 0, 0, 1, 1
c:\Dev\mobilecontrol\src\FrontEnd\src\assets\scss\core\cards\_card-form-horizontal.scss, SCSS, 0, 0, 0, 0, 25, 0, 4, 29
c:\Dev\mobilecontrol\src\FrontEnd\src\assets\scss\core\cards\_card-pricing.scss, SCSS, 0, 0, 0, 0, 78, 0, 14, 92
c:\Dev\mobilecontrol\src\FrontEnd\src\assets\scss\core\cards\_card-product.scss, SCSS, 0, 0, 0, 0, 39, 0, 5, 44
c:\Dev\mobilecontrol\src\FrontEnd\src\assets\scss\core\cards\_card-profile.scss, SCSS, 0, 0, 0, 0, 13, 0, 2, 15
c:\Dev\mobilecontrol\src\FrontEnd\src\assets\scss\core\cards\_card-rotate.scss, SCSS, 0, 0, 0, 0, 133, 1, 25, 159
c:\Dev\mobilecontrol\src\FrontEnd\src\assets\scss\core\cards\_card-signup.scss, SCSS, 0, 0, 0, 0, 37, 2, 6, 45
c:\Dev\mobilecontrol\src\FrontEnd\src\assets\scss\core\cards\_card-testimonials.scss, SCSS, 0, 0, 0, 0, 60, 0, 14, 74
c:\Dev\mobilecontrol\src\FrontEnd\src\assets\scss\core\mixins\_alert.scss, SCSS, 0, 0, 0, 0, 104, 15, 12, 131
c:\Dev\mobilecontrol\src\FrontEnd\src\assets\scss\core\mixins\_animations.scss, SCSS, 0, 0, 0, 0, 93, 1, 16, 110
c:\Dev\mobilecontrol\src\FrontEnd\src\assets\scss\core\mixins\_breakpoints.scss, SCSS, 0, 0, 0, 0, 20, 10, 5, 35
c:\Dev\mobilecontrol\src\FrontEnd\src\assets\scss\core\mixins\_buttons.scss, SCSS, 0, 0, 0, 0, 323, 16, 47, 386
c:\Dev\mobilecontrol\src\FrontEnd\src\assets\scss\core\mixins\_chartist.scss, SCSS, 0, 0, 0, 0, 61, 16, 16, 93
c:\Dev\mobilecontrol\src\FrontEnd\src\assets\scss\core\mixins\_colored-shadows.scss, SCSS, 0, 0, 0, 0, 107, 8, 24, 139
c:\Dev\mobilecontrol\src\FrontEnd\src\assets\scss\core\mixins\_drawer.scss, SCSS, 0, 0, 0, 0, 180, 38, 36, 254
c:\Dev\mobilecontrol\src\FrontEnd\src\assets\scss\core\mixins\_forms.scss, SCSS, 0, 0, 0, 0, 269, 77, 49, 395
c:\Dev\mobilecontrol\src\FrontEnd\src\assets\scss\core\mixins\_hover.scss, SCSS, 0, 0, 0, 0, 15, 1, 2, 18
c:\Dev\mobilecontrol\src\FrontEnd\src\assets\scss\core\mixins\_layout.scss, SCSS, 0, 0, 0, 0, 14, 1, 2, 17
c:\Dev\mobilecontrol\src\FrontEnd\src\assets\scss\core\mixins\_navbar-colors.scss, SCSS, 0, 0, 0, 0, 16, 0, 3, 19
c:\Dev\mobilecontrol\src\FrontEnd\src\assets\scss\core\mixins\_navs.scss, SCSS, 0, 0, 0, 0, 49, 1, 12, 62
c:\Dev\mobilecontrol\src\FrontEnd\src\assets\scss\core\mixins\_sidebar-color.scss, SCSS, 0, 0, 0, 0, 53, 0, 6, 59
c:\Dev\mobilecontrol\src\FrontEnd\src\assets\scss\core\mixins\_transparency.scss, SCSS, 0, 0, 0, 0, 16, 2, 2, 20
c:\Dev\mobilecontrol\src\FrontEnd\src\assets\scss\core\mixins\_type.scss, SCSS, 0, 0, 0, 0, 13, 1, 2, 16
c:\Dev\mobilecontrol\src\FrontEnd\src\assets\scss\core\mixins\_utilities.scss, SCSS, 0, 0, 0, 0, 92, 9, 9, 110
c:\Dev\mobilecontrol\src\FrontEnd\src\assets\scss\core\mixins\_variables.scss, SCSS, 0, 0, 0, 0, 14, 6, 9, 29
c:\Dev\mobilecontrol\src\FrontEnd\src\assets\scss\core\mixins\_vendor-prefixes.scss, SCSS, 0, 0, 0, 0, 174, 3, 25, 202
c:\Dev\mobilecontrol\src\FrontEnd\src\assets\scss\core\variables\_body.scss, SCSS, 0, 0, 0, 0, 1, 4, 2, 7
c:\Dev\mobilecontrol\src\FrontEnd\src\assets\scss\core\variables\_bootstrap-material-design-base.scss, SCSS, 0, 0, 0, 0, 25, 2, 7, 34
c:\Dev\mobilecontrol\src\FrontEnd\src\assets\scss\core\variables\_bootstrap-material-design.scss, SCSS, 0, 0, 0, 0, 152, 34, 50, 236
c:\Dev\mobilecontrol\src\FrontEnd\src\assets\scss\core\variables\_brand.scss, SCSS, 0, 0, 0, 0, 7, 2, 4, 13
c:\Dev\mobilecontrol\src\FrontEnd\src\assets\scss\core\variables\_buttons.scss, SCSS, 0, 0, 0, 0, 55, 22, 12, 89
c:\Dev\mobilecontrol\src\FrontEnd\src\assets\scss\core\variables\_card.scss, SCSS, 0, 0, 0, 0, 8, 11, 2, 21
c:\Dev\mobilecontrol\src\FrontEnd\src\assets\scss\core\variables\_code.scss, SCSS, 0, 0, 0, 0, 1, 1, 2, 4
c:\Dev\mobilecontrol\src\FrontEnd\src\assets\scss\core\variables\_colors-map.scss, SCSS, 0, 0, 0, 0, 0, 310, 2, 312
c:\Dev\mobilecontrol\src\FrontEnd\src\assets\scss\core\variables\_colors.scss, SCSS, 0, 0, 0, 0, 297, 2, 24, 323
c:\Dev\mobilecontrol\src\FrontEnd\src\assets\scss\core\variables\_custom-forms.scss, SCSS, 0, 0, 0, 0, 5, 0, 1, 6
c:\Dev\mobilecontrol\src\FrontEnd\src\assets\scss\core\variables\_drawer.scss, SCSS, 0, 0, 0, 0, 2, 2, 2, 6
c:\Dev\mobilecontrol\src\FrontEnd\src\assets\scss\core\variables\_dropdown.scss, SCSS, 0, 0, 0, 0, 1, 18, 2, 21
c:\Dev\mobilecontrol\src\FrontEnd\src\assets\scss\core\variables\_forms.scss, SCSS, 0, 0, 0, 0, 19, 12, 7, 38
c:\Dev\mobilecontrol\src\FrontEnd\src\assets\scss\core\variables\_layout.scss, SCSS, 0, 0, 0, 0, 0, 1, 1, 2
c:\Dev\mobilecontrol\src\FrontEnd\src\assets\scss\core\variables\_list-group.scss, SCSS, 0, 0, 0, 0, 3, 16, 2, 21
c:\Dev\mobilecontrol\src\FrontEnd\src\assets\scss\core\variables\_menu.scss, SCSS, 0, 0, 0, 0, 12, 2, 5, 19
c:\Dev\mobilecontrol\src\FrontEnd\src\assets\scss\core\variables\_modals.scss, SCSS, 0, 0, 0, 0, 15, 17, 3, 35
c:\Dev\mobilecontrol\src\FrontEnd\src\assets\scss\core\variables\_nav.scss, SCSS, 0, 0, 0, 0, 25, 22, 11, 58
c:\Dev\mobilecontrol\src\FrontEnd\src\assets\scss\core\variables\_pagination.scss, SCSS, 0, 0, 0, 0, 5, 0, 2, 7
c:\Dev\mobilecontrol\src\FrontEnd\src\assets\scss\core\variables\_shadow.scss, SCSS, 0, 0, 0, 0, 25, 2, 9, 36
c:\Dev\mobilecontrol\src\FrontEnd\src\assets\scss\core\variables\_snackbar.scss, SCSS, 0, 0, 0, 0, 5, 0, 2, 7
c:\Dev\mobilecontrol\src\FrontEnd\src\assets\scss\core\variables\_spacing.scss, SCSS, 0, 0, 0, 0, 1, 24, 2, 27
c:\Dev\mobilecontrol\src\FrontEnd\src\assets\scss\core\variables\_state.scss, SCSS, 0, 0, 0, 0, 9, 3, 5, 17
c:\Dev\mobilecontrol\src\FrontEnd\src\assets\scss\core\variables\_tables.scss, SCSS, 0, 0, 0, 0, 5, 0, 2, 7
c:\Dev\mobilecontrol\src\FrontEnd\src\assets\scss\core\variables\_tooltip.scss, SCSS, 0, 0, 0, 0, 1, 0, 1, 2
c:\Dev\mobilecontrol\src\FrontEnd\src\assets\scss\core\variables\_type.scss, SCSS, 0, 0, 0, 0, 42, 46, 20, 108
c:\Dev\mobilecontrol\src\FrontEnd\src\assets\scss\dashboard\_alerts.scss, SCSS, 0, 0, 0, 0, 92, 2, 16, 110
c:\Dev\mobilecontrol\src\FrontEnd\src\assets\scss\dashboard\_cards.scss, SCSS, 0, 0, 0, 0, 317, 2, 60, 379
c:\Dev\mobilecontrol\src\FrontEnd\src\assets\scss\dashboard\_fileupload.scss, SCSS, 0, 0, 0, 0, 115, 0, 4, 119
c:\Dev\mobilecontrol\src\FrontEnd\src\assets\scss\dashboard\_fixed-plugin.scss, SCSS, 0, 0, 0, 0, 277, 1, 28, 306
c:\Dev\mobilecontrol\src\FrontEnd\src\assets\scss\dashboard\_forms.scss, SCSS, 0, 0, 0, 0, 27, 0, 5, 32
c:\Dev\mobilecontrol\src\FrontEnd\src\assets\scss\dashboard\_misc.scss, SCSS, 0, 0, 0, 0, 99, 0, 12, 111
c:\Dev\mobilecontrol\src\FrontEnd\src\assets\scss\dashboard\_navbar.scss, SCSS, 0, 0, 0, 0, 69, 0, 9, 78
c:\Dev\mobilecontrol\src\FrontEnd\src\assets\scss\dashboard\_pages.scss, SCSS, 0, 0, 0, 0, 411, 0, 82, 493
c:\Dev\mobilecontrol\src\FrontEnd\src\assets\scss\dashboard\_responsive.scss, SCSS, 0, 0, 0, 0, 469, 1, 77, 547
c:\Dev\mobilecontrol\src\FrontEnd\src\assets\scss\dashboard\_rtl.scss, SCSS, 0, 0, 0, 0, 275, 0, 47, 322
c:\Dev\mobilecontrol\src\FrontEnd\src\assets\scss\dashboard\_sidebar-and-main-panel.scss, SCSS, 0, 0, 0, 0, 515, 2, 87, 604
c:\Dev\mobilecontrol\src\FrontEnd\src\assets\scss\dashboard\_social-buttons.scss, SCSS, 0, 0, 0, 0, 3, 2, 1, 6
c:\Dev\mobilecontrol\src\FrontEnd\src\assets\scss\dashboard\_tables.scss, SCSS, 0, 0, 0, 0, 117, 0, 14, 131
c:\Dev\mobilecontrol\src\FrontEnd\src\assets\scss\dashboard\_timeline.scss, SCSS, 0, 0, 0, 0, 160, 0, 38, 198
c:\Dev\mobilecontrol\src\FrontEnd\src\assets\scss\material-dashboard.scss, SCSS, 0, 0, 0, 0, 59, 20, 8, 87
c:\Dev\mobilecontrol\src\FrontEnd\src\assets\scss\plugins\_animate.scss, SCSS, 0, 0, 0, 0, 153, 7, 71, 231
c:\Dev\mobilecontrol\src\FrontEnd\src\assets\scss\plugins\_chartist.scss, SCSS, 0, 0, 0, 0, 254, 25, 50, 329
c:\Dev\mobilecontrol\src\FrontEnd\src\assets\scss\plugins\_datatables.net.scss, SCSS, 0, 0, 0, 0, 466, 574, 91, 1131
c:\Dev\mobilecontrol\src\FrontEnd\src\assets\scss\plugins\_fullcalendar.scss, SCSS, 0, 0, 0, 0, 974, 196, 323, 1493
c:\Dev\mobilecontrol\src\FrontEnd\src\assets\scss\plugins\_jquery.jvectormap.scss, SCSS, 0, 0, 0, 0, 114, 1, 23, 138
c:\Dev\mobilecontrol\src\FrontEnd\src\assets\scss\plugins\_perfect-scrollbar.scss, SCSS, 0, 0, 0, 0, 83, 18, 12, 113
c:\Dev\mobilecontrol\src\FrontEnd\src\assets\scss\plugins\_plugin-bootstrap-select.scss, SCSS, 0, 0, 0, 0, 318, 12, 8, 338
c:\Dev\mobilecontrol\src\FrontEnd\src\assets\scss\plugins\_plugin-datetime-picker.scss, SCSS, 0, 0, 0, 0, 205, 15, 12, 232
c:\Dev\mobilecontrol\src\FrontEnd\src\assets\scss\plugins\_plugin-flexisel.scss, SCSS, 0, 0, 0, 0, 54, 7, 12, 73
c:\Dev\mobilecontrol\src\FrontEnd\src\assets\scss\plugins\_plugin-nouislider.scss, SCSS, 0, 0, 0, 0, 191, 4, 14, 209
c:\Dev\mobilecontrol\src\FrontEnd\src\assets\scss\plugins\_plugin-tagsinput.scss, SCSS, 0, 0, 0, 0, 171, 12, 23, 206
c:\Dev\mobilecontrol\src\FrontEnd\src\assets\scss\plugins\_select-bootstrap.scss, SCSS, 0, 0, 0, 0, 126, 43, 5, 174
c:\Dev\mobilecontrol\src\FrontEnd\src\assets\scss\plugins\_sweetalert2.scss, SCSS, 0, 0, 0, 0, 3, 0, 1, 4
c:\Dev\mobilecontrol\src\FrontEnd\src\assets\scss\plugins\_wizard-card.scss, SCSS, 0, 0, 0, 0, 185, 0, 39, 224
c:\Dev\mobilecontrol\src\FrontEnd\src\environments\environment.prod.ts, TypeScript, 3, 0, 0, 0, 0, 0, 1, 4
c:\Dev\mobilecontrol\src\FrontEnd\src\environments\environment.ts, TypeScript, 3, 0, 0, 0, 0, 4, 2, 9
c:\Dev\mobilecontrol\src\FrontEnd\src\index.html, HTML, 0, 0, 0, 25, 0, 2, 6, 33
c:\Dev\mobilecontrol\src\FrontEnd\src\main.ts, TypeScript, 9, 0, 0, 0, 0, 0, 4, 13
c:\Dev\mobilecontrol\src\FrontEnd\src\polyfills.ts, TypeScript, 15, 0, 0, 0, 0, 37, 16, 68
c:\Dev\mobilecontrol\src\FrontEnd\src\styles.css, CSS, 0, 116, 0, 0, 0, 9, 21, 146
c:\Dev\mobilecontrol\src\FrontEnd\src\test.ts, TypeScript, 13, 0, 0, 0, 0, 4, 4, 21
c:\Dev\mobilecontrol\src\FrontEnd\src\tsconfig.app.json, JSON, 0, 0, 9, 0, 0, 3, 0, 12
c:\Dev\mobilecontrol\src\FrontEnd\src\tsconfig.spec.json, JSON, 0, 0, 18, 0, 0, 0, 1, 19
c:\Dev\mobilecontrol\src\FrontEnd\src\tslint.json, JSON, 0, 0, 17, 0, 0, 0, 1, 18
c:\Dev\mobilecontrol\src\FrontEnd\src\typings.d.ts, TypeScript, 4, 0, 0, 0, 0, 1, 1, 6
Total, -, 6881, 350, 44, 6115, 13458, 2620, 4046, 33514